NO ./img/wallNorth.xpm
SO ./img/wallSouth.xpm
WE ./img/wallWest.xpm
EA ./img/wallEast.xpm

                 
F 27,4,31
C 145,177,230

              
        1111111111111111111111111
        10100000001100000000000011111111111
        10110000011100010000000000000000101
        1001000000000000S000000000000000001
1111111110110000011100010000000011111111111
100000000001000001110111111111111
11110111111111011100000010001
11110111111111011101010010001
11000000110101011100000010001
10001000000000001100000000001
1001 1000000000001101010010001
110010011101010111110111100111
11110111 1110101 101111010001
1111111111111111 111111111111
