NO ./path_to_the_north_texture 
SO ./path_to_the_south_texture
WE ./path_to_the_west_texture 
EA ./path_to_the_east_texture

                 
F 173,143,50
C 145,177,230

              
        1111111111111111111111111
        1010000000110000000000001
        1011000001110001000000001
        1001000000000000000000001
111111111011000001110001000000001
100000000011000001110111111111111
11110111111111011100000010001
11110111111111011101010010001
11000000110101011100000010001
10001000000000001100000000001
1001 1000000000001101010010001
11001001110101011111011110N0111
11110111 1110101 101111010001
1111111111111111 111111111111